{
	"tileset" : "link-donjon.png",
	"terrain" : [
		[5,  7,  7,  7,  7,  7,  7,  7,  7,  7,  7,  7,  7,  7,  7],
		[5,  28, 7,  7,  7,  7,  7,  7,  7,  7,  7,  7,  7,  7,  7],
		[5,  28, 7,  7,  7,  7,  7,  7,  7,  7,  7,  7,  7,  7,  7],
		[5,  28, 7,  7,  7,  7,  7,  7,  7,  7,  7,  7,  7,  7,  7],
		[5,  28, 7,  7,  7,  7,  7,  7,  7,  7,  7,  7,  7,  7,  7],
		[5,  28, 7,  7,  7,  7,  7,  7,  7,  7,  7,  7,  7,  7,  7],
		[5,  28, 7,  7,  7,  7,  7,  7,  7,  7,  7,  7,  7,  7,  7],
		[5,  28, 7,  7,  7,  7,  7,  5,  7,  7,  7,  7,  7,  7,  7],
		[5,  28, 28, 28, 28, 28, 28, 7,  7,  7,  7,  7,  7,  7,  7],
		[5,  7,  7,  7,  7,  7,  28, 7,  7,  7,  7,  7,  7,  7,  7],
		[5,  7,  7,  7,  7,  7,  28, 7,  7,  7,  7,  7,  7,  7,  7],
		[5,  7,  7,  7,  7,  7,  28, 7,  7,  7,  7,  7,  7,  7,  7],
		[5,  7,  7,  7,  7,  7,  28, 7,  7,  7,  7,  7,  7,  7,  7],
		[5,  7,  7,  7,  7,  7,  28, 28, 28, 28, 28, 28, 7,  7,  7],
		[5,  5,  5,  5,  5,  5,  5,  5,  5,  5,  5,  5,  5,  5,  5]
	]
}
