{
	"tileset" : "link-donjon.png",
	"terrain" : [
		[5,  5,  5,  5,  5,  5,  5,  5,  5,  5,  5,  5,  5,  5,  5],
		[7,  29, 7,  7,  7,  7,  7,  7,  7,  7,  7,  7,  7,  7,  5],
		[7,  29, 7,  7,  7,  7,  7,  5,  5,  5,  5,  7,  7,  7,  5],
		[7,  29, 7,  7,  7,  7,  7,  7,  7,  7,  7,  7,  7,  7,  5],
		[7,  29, 7,  7,  7,  7,  7,  7,  7,  7,  7,  7,  7,  7,  5],
		[7,  29, 7,  7,  7,  7,  7,  7,  7,  7,  7,  7,  7,  7,  5],
		[7,  29, 7,  7,  7,  7,  7,  7,  7,  5,  5,  5,  5,  5,  5],
		[7,  29, 7,  7,  7,  7,  7,  7,  7,  5,  7,  7,  7,  7,  5],
		[7,  29, 29, 29, 29, 29, 29, 7,  7,  5,  7,  7,  7,  7,  5],
		[7,  7,  7,  7,  7,  7,  29, 7,  7,  7,  7,  7,  7,  7,  5],
		[7,  7,  7,  7,  7,  7,  29, 7,  7,  5,  7,  7,  7,  7,  5],
		[7,  7,  7,  7,  7,  7,  29, 7,  7,  5,  5,  5,  5,  5,  5],
		[7,  7,  7,  7,  7,  7,  29, 7,  7,  7,  7,  7,  7,  7,  5],
		[7,  7,  7,  7,  7,  7,  29, 29, 29, 29, 29, 29, 1,  7,  5],
		[7,  7,  7,  7,  7,  7,  7,  7,  7,  7,  7,  7,  7,  7,  5]
	]
}
