{
	"tileset" : "link-donjon.png",
	"terrain" : [
		[7,  7,  7,  7,  7,  7,  7,  7,  7,  7,  7,  7,  7,  7,  5],
		[7,  28, 7,  7,  7,  7,  7,  7,  7,  7,  7,  7,  7,  7,  5],
		[7,  28, 7,  7,  7,  7,  7,  5,  5,  5,  5,  7,  7,  7,  5],
		[7,  28, 7,  7,  7,  7,  7,  7,  7,  5,  5,  7,  7,  7,  5],
		[7,  28, 7,  7,  7,  7,  7,  7,  7,  5,  5,  7,  7,  7,  5],
		[7,  28, 7,  7,  7,  7,  7,  7,  7,  5,  7,  7,  7,  7,  5],
		[7,  28, 7,  7,  7,  7,  7,  7,  7,  5,  7,  5,  5,  5,  5],
		[7,  28, 7,  7,  7,  7,  7,  7,  7,  5,  7,  5,  5,  5,  5],
		[7,  28, 28, 28, 28, 28, 28, 7,  7,  5,  7,  5,  5,  5,  5],
		[7,  7,  7,  7,  7,  7,  28, 7,  7,  5,  7,  7,  7,  7,  5],
		[7,  7,  7,  7,  7,  7,  28, 7,  7,  5,  5,  5,  5,  7,  5],
		[7,  7,  7,  7,  7,  7,  28, 7,  7,  5,  5,  5,  5,  7,  5],
		[7,  7,  7,  7,  7,  7,  28, 7,  7,  7,  7,  7,  7,  7,  5],
		[7,  7,  7,  7,  7,  7,  28, 28, 28, 28, 28, 28, 1,  7,  5],
		[5,  5,  5,  5,  5,  5,  5,  5,  5,  5,  5,  5,  5,  5,  5]
	]
}
