{
	"tileset" : "link-donjon.png",
	"terrain" : [
		[6,  6,  6,  6,  6,  6,  6,  6,  6,  6,  6,  6,  6,  6,  6],
		[8,  29, 8,  8,  8,  8,  8,  8,  8,  8,  8,  8,  8,  8,  6],
		[8,  29, 8,  8,  8,  8,  8,  6,  6,  6,  6,  8,  8,  8,  6],
		[8,  29, 8,  8,  8,  8,  8,  8,  8,  8,  8,  8,  8,  8,  6],
		[8,  29, 8,  8,  8,  8,  8,  8,  8,  8,  8,  8,  8,  8,  6],
		[8,  29, 8,  8,  8,  8,  8,  8,  8,  8,  8,  8,  8,  8,  6],
		[8,  29, 8,  8,  8,  8,  8,  8,  8,  6,  6,  6,  6,  6,  6],
		[8,  29, 8,  8,  8,  8,  8,  8,  8,  6,  8,  8,  8,  8,  6],
		[8,  29, 29, 29, 29, 29, 29, 8,  8,  6,  8,  8,  8,  8,  6],
		[8,  8,  8,  8,  8,  8,  29, 8,  8,  8,  8,  8,  8,  8,  6],
		[8,  8,  8,  8,  8,  8,  29, 8,  8,  6,  8,  8,  8,  8,  6],
		[8,  8,  8,  8,  8,  8,  29, 8,  8,  6,  6,  6,  6,  6,  6],
		[8,  8,  8,  8,  8,  8,  29, 8,  8,  8,  8,  8,  8,  8,  6],
		[8,  8,  8,  8,  8,  8,  29, 29, 29, 29, 29, 29, 2,  8,  6],
		[8,  8,  8,  8,  8,  8,  8,  8,  8,  8,  8,  8,  8,  8,  6]
	]
}
