{
	"tileset" : "link-donjon.png",
	"terrain" : [
		[5,  5,  5,  5,  5,  5,  5,  5,  5,  5,  5,  5,  5,  5,  5],
		[5,  7,  7,  7,  7,  7,  28, 7,  7,  7,  7,  7,  7,  7,  5],
		[5,  7,  7,  7,  7,  7,  28, 5,  5,  5,  5,  7,  7,  7,  5],
		[5,  7,  7,  7,  5,  7,  28, 7,  7,  5,  5,  7,  7,  7,  5],
		[5,  7,  7,  5,  5,  7,  28, 7,  7,  5,  5,  7,  7,  7,  5],
		[5,  7,  7,  5,  5,  7,  28, 7,  7,  5,  7,  7,  7,  7,  5],
		[5,  7,  5,  5,  5,  5,  28, 7,  7,  5,  7,  5,  5,  5,  5],
		[5,  7,  7,  5,  5,  7,  28, 7,  7,  5,  7,  5,  5,  5,  5],
		[5,  7,  7,  7,  7,  7,  28, 7,  7,  5,  7,  5,  5,  5,  5],
		[5,  7,  7,  7,  7,  7,  28, 7,  7,  5,  7,  7,  7,  7,  5],
		[5,  7,  7,  7,  7,  7,  28, 7,  7,  5,  5,  5,  5,  7,  5],
		[5,  7,  7,  7,  7,  7,  28, 7,  7,  5,  5,  5,  5,  7,  5],
		[5,  7,  7,  7,  7,  7,  28, 7,  7,  7,  7,  7,  7,  7,  5],
		[5,  7,  7,  7,  7,  7,  28, 28, 28, 28, 28, 28, 2,  7,  5],
		[5,  7,  7,  7,  7,  7,  7,  7,  7,  7,  7,  7,  7,  7,  5]
	]
}
